Organism Name,NucleotideSequence,ORF,Reading Direction,Nesting Level,Start codon,End codon,ORFLength
Porcine circovirus 1,atgacgtggccaaggaggcgttaccgcagaagaaggacccgcccccgcagccatcttggaaacatcctccggagaagaccatatttggcacaccccgccttcagaaaccgttacagatggcgccgaaagacgggtatcttcaattcccgcctttctagagaatttgtactcaccataaaaggaggatactcgcagccatcttggaatgttaaccacctcaaattcaacatcggccagttcctccccccctcaggcggcaccaacccactacccctacctttccaatactaccgtattagaaaggctaaatatgaattttaccccagagaccccatcacctctaatcaaagaggtgttgggtccactgttgttatcttggatgccaactttgtaaccccctccaccaacttggcctatgacccctatattaactactcctcccgccacaccataaggcagccctttacctaccactccaggtacttcacccccaaacctgagctggaccaaacaattgattggttccacccaaataataaaagaaaccagctgtggctccatttaaatacccacaccaatgtcgagcacacaggcctcggctatgcgctccaaaatgcagccacagcccaaaattatgtggtaaggctgactatttatgtacaattcagagaatttatcctaaaagaccctctaaataaataa,MTWPRRRYRRRRTRPRSHLGNILRRRPYLAHPAFRNRYRWRRKTGIFNSRLSREFVLTIKGGYSQPSWNVNHLKFNIGQFLPPSGGTNPLPLPFQYYRIRKAKYEFYPRDPITSNQRGVGSTVVILDANFVTPSTNLAYDPYINYSSRHTIRQPFTYHSRYFTPKPELDQTIDWFHPNNKRNQLWLHLNTHTNVEHTGLGYALQNAATAQNYVVRLTIYVQFREFILKDPLNK,right to left,0,1723,1021,702
Porcine circovirus 1,atgatatccatcccaccacttatttctactaggcttccagtaggtgtcgctaggctcagcaaaattacgggcccactggctcttcccacaaccgggcgggcccactatgacgtgtacagctgtcttccaatcacgctgctgcatcttcccgctcactttcaaaagttcagccagcccgcggaaatttctcacatacgttacagggaactgctcggctacagtcaccaaagaccccgtctccaaaagggtactcacagcagtagacaagtcgctgcgcttcccctggttccgcggagctccacactcgataagtatgtggccttctttactgcagtattctttattctgctggtcggttcctttcgctttctcgatgtggcagcgggcaccaaaataccacttcaccttgttaaaagtctgcttcttagcaaaattcgcaaacccctggaggtgaggagttctaccctcttccaaaccttcctctccgcaaacaaaataatcaaaaagggagattggaagctcccgtattttgtttttctcctcctcggaaggattattaagggtgaacacccacctcttatggggttgcgggccgcttttcttgcttggcattttcactga,MISIPPLISTRLPVGVARLSKITGPLALPTTGRAHYDVYSCLPITLLHLPAHFQKFSQPAEISHIRYRELLGYSHQRPRLQKGTHSSRQVAALPLVPRSSTLDKYVAFFTAVFFILLVGSFRFLDVAAGTKIPLHLVKSLLLSKIRKPLEVRSSTLFQTFLSANKIIKKGDWKLPYFVFLLLGRIIKGEHPPLMGLRAAFLAWHFH,right to left,1,658,37,621
Porcine circovirus 1,atggtactcctcaactgctgtcccagctgtagaagctctctatcggaggattactactttgcaattttggaagactgctggagaacaatccacggaggtacccgaaggccgatttga,MVLLNCCPSCRSSLSEDYYFAILEDCWRTIHGGTRRPI,left to right,1,819,936,117
Porcine circovirus 1,atggtcttctccggaggatgtttccaagatggctgcgggggcgggtccttcttctgcggtaacgcctccttggccacgtcatcctataaaagtgaaagaagtgcgctgctgtag,MVFSGGCFQDGCGGGSFFCGNASLATSSYKSERSALL,left to right,2,1641,1755,114
Porcine circovirus 1,atgttaaccacctcaaattcaacatcggccagttcctccccccctcaggcggcaccaacccactacccctacctttccaatactaccgtattagaaaggctaaatatgaattttaccccagagaccccatcacctctaatcaaagaggtgttgggtccactgttgttatcttggatgccaactttgtaa,MLTTSNSTSASSSPPQAAPTHYPYLSNTTVLERLNMNFTPETPSPLIKEVLGPLLLSWMPTL,right to left,2,1518,1329,189
Porcine circovirus 1,atgacgtgtacagctgtcttccaatcacgctgctgcatcttcccgctcactttcaaaagttcagccagcccgcggaaatttctcacatacgttacagggaactgctcggctacagtcaccaaagaccccgtctccaaaagggtactcacagcagtagacaagtcgctgcgcttcccctggttccgcggagctccacactcgataagtatgtggccttctttactgcagtattctttattctgctggtcggttcctttcgctttctcgatgtggcagcgggcaccaaaataccacttcaccttgttaaaagtctgcttcttagcaaaattcgcaaacccctggaggtga,MTCTAVFQSRCCIFPLTFKSSASPRKFLTYVTGNCSATVTKDPVSKRVLTAVDKSLRFPWFRGAPHSISMWPSLLQYSLFCWSVPFAFSMWQRAPKYHFTLLKVCFLAKFANPWR,right to left,2,552,204,348
Porcine circovirus 1,atgccaagcaagaaaagcggcccgcaaccccataagaggtgggtgttcacccttaataatccttccgaggaggagaaaaacaaaatacgggagcttccaatctccctttttgattattttgtttgcggagaggaaggtttggaagagggtagaactcctcacctccaggggtttgcgaattttgctaagaagcagacttttaacaaggtgaagtggtattttggtgcccgctgccacatcgagaaagcgaaaggaaccgaccagcagaataaagaatactgcagtaaagaaggccacatacttatcgagtgtggagctccgcggaaccaggggaagcgcagcgacttgtctactgctgtgagtacccttttggagacggggtctttggtgactgtagccgagcagttccctgtaacgtatgtgagaaatttccgcgggctggctgaacttttgaaagtgagcgggaagatgcagcagcgtgattggaagacagctgtacacgtcatagtgggcccgcccggttgtgggaagagccagtgggcccgtaattttgctgagcctagcgacacctactggaagcctagtagaaataagtggtgggatggatatcatggagaagaagttgttgttttggatgatttttatggctggttaccttgggatgatctactgagactgtgtgaccggtatccattgactgtagagactaaagggggtactgttccttttttggcccgcagtattttgattaccagcaatcaggccccccaggaatggtactcctcaactgctgtcccagctgtagaagctctctatcggaggattactactttgcaattttggaagactgctggagaacaatccacggaggtacccgaaggccgatttgaagcagtggacccaccctgtgcccttttcccatataaaataaattactga,MPSKKSGPQPHKRWVFTLNNPSEEEKNKIRELPISLFDYFVCGEEGLEEGRTPHLQGFANFAKKQTFNKVKWYFGARCHIEKAKGTDQQNKEYCSKEGHILIECGAPRNQGKRSDLSTAVSTLLETGSLVTVAEQFPVTYVRNFRGLAELLKVSGKMQQRDWKTAVHVIVGPPGCGKSQWARNFAEPSDTYWKPSRNKWWDGYHGEEVVVLDDFYGWLPWDDLLRLCDRYPLTVETKGGTVPFLARSILITSNQAPQEWYSSTAVPAVEALYRRITTLQFWKTAGEQSTEVPEGRFEAVDPPCALFPYKINY,left to right,0,46,985,939
Porcine circovirus 1,atggagccacagctggtttcttttattatttgggtggaaccaatcaattgtttggtccagctcaggtttgggggtgaagtacctggagtggtaggtaaagggctgccttatggtgtggcgggaggagtagttaatataggggtcataggccaagttggtggagggggttacaaagttggcatccaagataacaacagtggacccaacacctctttgattagaggtgatggggtctctggggtaaaattcatatttagcctttctaatacggtagtattggaaaggtag,MEPQLVSFIIWVEPINCLVQLRFGGEVPGVVGKGLPYGVAGGVVNIGVIGQVGGGGYKVGIQDNNSGPNTSLIRGDGVSGVKFIFSLSNTVVLER,left to right,1,1162,1450,288
Porcine circovirus 1,atggctgcgggggcgggtccttcttctgcggtaacgcctccttggccacgtcatcctataaaagtgaaagaagtgcgctgctgtagtattaccagcgcacttcggcagcggcagcacctcggcagcgtcagtgaaaatgccaagcaagaaaagcggcccgcaaccccataa,MAAGAGPSSAVTPPWPRHPIKVKEVRCCSITSALRQRQHLGSVSENAKQEKRPATP,left to right,1,1669,1840,171
Porcine circovirus 1,atgggaaaagggcacagggtgggtccactgcttcaaatcggccttcgggtacctccgtggattgttctccagcagtcttccaaaattgcaaagtag,MGKGHRVGPLLQIGLRVPPWIVLQQSSKIAK,right to left,2,968,872,96
Porcine circovirus 1,atggataccggtcacacagtctcagtagatcatcccaaggtaaccagccataaaaatcatccaaaacaacaacttcttctccatgatatccatcccaccacttatttctactag,MDTGHTVSVDHPKVTSHKNHPKQQLLLHDIHPTTYFY,right to left,2,740,626,114
Porcine circovirus 1,atgttgaatttgaggtggttaacattccaagatggctgcgagtatcctccttttatggtgagtacaaattctctagaaaggcgggaattgaagatacccgtctttcggcgccatctgtaa,MLNLRWLTFQDGCEYPPFMVSTNSLERRELKIPVFRRHL,left to right,2,1493,1613,120
Porcine circovirus 2,atgacgtatccaaggaggcgttaccggagaagaagacaccgcccccgcagccatcttggccagatcctccgccgccgcccctggctcgtccacccccgccaccgttaccgctggagaaggaaaaatggcatcttcaacacccgcctctcccgcaccttcggatatactatcaagcgaaccacagtcaaaacgccctcctgggcggtggacatgatgagattcaatattaatgactttcttcccccaggagggggctcaaacccccgctctgtgccctttgaatactacagaataagaaaggttaaggttgaattctggccctgctccccgatcacccagggtgacaggggagtgggctccagtgctgttattctagatgataactttgtaacaaaggccacagccctcacctatgacccctatgtaaactactcctcccgccataccataacccagcccttctcctaccactcccgctactttacccccaaacctgtcctagattccactattgattacttccaaccaaacaacaaaagaaatcagctgtggctgagactacaaactactggaaatgtagaccacgtaggcctcggcactgcgttcgaaaacagtatatacgaccaggaatacaatatccgtgtaaccatgtatgtacaattcagagaatttaatcttaaagaccccccacttaacccctaa,MTYPRRRYRRRRHRPRSHLGQILRRRPWLVHPRHRYRWRRKNGIFNTRLSRTFGYTIKRTTVKTPSWAVDMMRFNINDFLPPGGGSNPRSVPFEYYRIRKVKVEFWPCSPITQGDRGVGSSAVILDDNFVTKATALTYDPYVNYSSRHTITQPFSYHSRYFTPKPVLDSTIDYFQPNNKRNQLWLRLQTTGNVDHVGLGTAFENSIYDQEYNIRVTMYVQFREFNLKDPPLNP,right to left,0,1734,1032,702
Porcine circovirus 2,atgtacacgtcattgtggggccacctgggtgtggtaaaagcaaatgggctgctaattttgcagacccggaaaccacatactggaaaccacctagaaacaagtggtgggatggttaccatggtgaagaagtggttgttattgatgacttttatggctggctgccctgggatgatctactga,MYTSLWGHLGVVKANGLLILQTRKPHTGNHLETSGGMVTMVKKWLLLMTFMAGCPGMIY,left to right,2,552,732,180
Porcine circovirus 2,atgctacagaacaatccacggaggaagggggccagttcgtcaccctttcccccccatgccctgaatttccatatgaaataa,MLQNNPRRKGASSSPFPPHALNFHMK,left to right,2,906,987,81
Porcine circovirus 2,atggcatcttcaacacccgcctctcccgcaccttcggatatactatcaagcgaaccacagtcaaaacgccctcctgggcggtggacatga,MASSTPASPAPSDILSSEPQSKRPPGRWT,right to left,2,1610,1520,90
Porcine circovirus 2,atggtaaccatcccaccacttgtttctaggtggtttccagtatgtggtttccgggtctgcaaaattagcagcccatttgcttttaccacacccaggtggccccacaatgacgtgtacattagtcttccaatcacgcttctgcattttcccgctcactttcaaaagttcagccagcccgcggaaatttctgacaaacgttacagggtgctgctctgcaacggtcaccagactcccgctctccaacaaggtactcacagcagtagacaggtcactccgttgtccctgagatctaggagctccacactccatcagtaa,MVTIPPLVSRWFPVCGFRVCKISSPFAFTTPRWPHNDVYISLPITLLHFPAHFQKFSQPAEISDKRYRVLLCNGHQTPALQQGTHSSRQVTPLSLRSRSSTLHQ,right to left,1,671,356,315
Porcine circovirus 2,atggggttggggtccgcttcttccattcttcttgctgggcatgttgctgccgagctgctgccgaggtgctgccgctgccgaagtgcgctggtaatacttacagcgcacttctttcgttttcagatatga,MGLGSASSILLAGHVAAELLPRCCRCRSALVILTAHFFRFQI,right to left,1,92,-37,129
Porcine circovirus 2,atggtactcctcaactgctgtcccagctgtagaagctctttatcggaggattacttccttggtattttggaagaatgctacagaacaatccacggaggaagggggccagttcgtcaccctttcccccccatgccctga,MVLLNCCPSCRSSLSEDYFLGILEECYRTIHGGRGPVRHPFPPMP,left to right,1,832,970,138
Porcine circovirus 2,atggttacacggatattgtattcctggtcgtatatactgttttcgaacgcagtgccgaggcctacgtggtctacatttccagtagtttgtagtctcagccacagctga,MVTRILYSWSYILFSNAVPRPTWSTFPVVCSLSHS,left to right,1,1084,1192,108
Porcine circovirus 2,atgtccaccgcccaggagggcgttttgactgtggttcgcttgatagtatatccgaaggtgcgggagaggcgggtgttgaagatgccatttttccttctccagcggtaa,MSTAQEGVLTVVRLIVYPKVRERRVLKMPFFLLQR,left to right,1,1522,1630,108
Porcine circovirus 2,atgacgtgtacattagtcttccaatcacgcttctgcattttcccgctcactttcaaaagttcagccagcccgcggaaatttctgacaaacgttacagggtgctgctctgcaacggtcaccagactcccgctctccaacaaggtactcacagcagtagacaggtcactccgttgtccctga,MTCTLVFQSRFCIFPLTFKSSASPRKFLTNVTGCCSATVTRLPLSNKVLTAVDRSLRCP,right to left,2,565,385,180
Porcine circovirus 2,atgtggcagcgggcacccaaataccacttcactttattaaaagtctgcttcttcacaaaattagcgaacccctggaggtga,MWQRAPKYHFTLLKVCFFTKLANPWR,right to left,1,298,217,81
Porcine circovirus 2,atgcccagcaagaagaatggaagaagcggaccccaaccccataaaaggtgggtgttcacactgaataatccttccgaagacgagcgcaagaaaatacgggatcttccaatatccctatttgattattttattgttggcgaggagggtaatgaggaaggacgaacacctcacctccaggggttcgctaattttgtgaagaagcagacttttaataaagtgaagtggtatttgggtgcccgctgccacatcgagaaagcgaaaggaacagatcagcagaataaagaatactgcagtaaagaaggcaacttactgatggagtgtggagctcctagatctcagggacaacggagtgacctgtctactgctgtgagtaccttgttggagagcgggagtctggtgaccgttgcagagcagcaccctgtaacgtttgtcagaaatttccgcgggctggctgaacttttgaaagtgagcgggaaaatgcagaagcgtgattggaagactaatgtacacgtcattgtggggccacctgggtgtggtaaaagcaaatgggctgctaattttgcagacccggaaaccacatactggaaaccacctagaaacaagtggtgggatggttaccatggtgaagaagtggttgttattgatgacttttatggctggctgccctgggatgatctactgagactgtgtgatcgatatccattgactgtagagactaaaggtggaactgtaccttttttggcccgcagtattctgattaccagcaatcagaccccgttggaatggtactcctcaactgctgtcccagctgtagaagctctttatcggaggattacttccttggtattttggaagaatgctacagaacaatccacggaggaagggggccagttcgtcaccctttcccccccatgccctgaatttccatatgaaataaattactga,MPSKKNGRSGPQPHKRWVFTLNNPSEDERKKIRDLPISLFDYFIVGEEGNEEGRTPHLQGFANFVKKQTFNKVKWYLGARCHIEKAKGTDQQNKEYCSKEGNLLMECGAPRSQGQRSDLSTAVSTLLESGSLVTVAEQHPVTFVRNFRGLAELLKVSGKMQKRDWKTNVHVIVGPPGCGKSKWAANFADPETTYWKPPRNKWWDGYHGEEVVVIDDFYGWLPWDDLLRLCDRYPLTVETKGGTVPFLARSILITSNQTPLEWYSSTAVPAVEALYRRITSLVFWKNATEQSTEEGGQFVTLSPPCPEFPYEINY,left to right,0,50,995,945
Porcine circovirus 3,atgtttttattggtcctccaggatgcgggaaaacgcgggaagcttgtgcggatgcggctgcgcgggaattgcagttgtatttcaagccacgggggccttggtgggatggttataatggggagggtgctgttattttggatgatttttatgggtgggttccatttgatgaattgctga,MFLLVLQDAGKRGKLVRMRLRGNCSCISSHGGLGGMVIMGRVLLFWMIFMGGFHLMNC,left to right,2,702,879,177
Porcine circovirus 3,atgttgtaccggaggagtggtattcatcggagaatattcgtggaaagttggaggccttgtttaggaggttcactaaggttgtttgttggggggaggggggggtaa,MLYRRSGIHRRIFVESWRPCLGGSLRLFVGGRGG,left to right,2,963,1068,105
Porcine circovirus 3,atgcgagggcgtttacctgtgcccgcacccgaagcgcagcgggagcgcgcgcgaggggacacggcttgtcgccaccggaggggtcagatttatatttattttcacttagagaacggacttgtaacgaatccaaacttctttggtgccgtagaagtctgtcattccagttttttccgggacataaatgctccaaagcagtgctccccattgaacggtggggtcatatgtgttgagccatggggtgggtctggagaaaaagaagaggctttgtcctgggtgagcgctggtagttcccgccagaagtggtttgggggtgaagtaacggctgtgtttttttttagaagtcataactttacgagtggaactttccgcataagggtcgtcttggagccaagtgtttgtggtccaggcgccgtctag,MRGRLPVPAPEAQRERARGDTACRHRRGQIYIYFHLENGLVTNPNFFGAVEVCHSSFFRDINAPKQCSPLNGGVICVEPWGGSGEKEEALSWVSAGSSRQKWFGGEVTAVFFFRSHNFTSGTFRIRVVLEPSVCGPGAV,left to right,1,1230,1650,420
Porcine circovirus 3,atggggagcactgctttggagcatttatgtcccggaaaaaactggaatgacagacttctacggcaccaaagaagtttggattcgttacaagtccgttctctaagtgaaaataaatataaatctgacccctccggtggcgacaagccgtgtcccctcgcgcgcgctcccgctgcgcttcgggtgcgggcacaggtaaacgccctcgcatgtggggaccccatcccccacatgcttcggtgggggcgacaagccgtggctagggggctgcccacccaccctcccaataaatacccccaccccaacgcaataattgtacacaagtgcaaataa,MGSTALEHLCPGKNWNDRLLRHQRSLDSLQVRSLSENKYKSDPSGGDKPCPLARAPAALRVRAQVNALACGDPIPHMLRWGRQAVARGLPTHPPNKYPHPNAIIVHKCK,right to left,2,1438,1108,330
Porcine circovirus 3,atgtctttctttacccccccctccccccaacaaacaaccttagtgaacctcctaaacaaggcctccaactttccacgaatattctccgatgaataccactcctccggtacaacattactagtaatatataataccttagccacaaaattaacaaacccacccttaacaggaaccctcagagggtacctgtccccaattctcagcaattcatcaaatggaacccacccataa,MSFFTPPSPQQTTLVNLLNKASNFPRIFSDEYHSSGTTLLVIYNTLATKLTNPPLTGTLRGYLSPILSNSSNGTHP,right to left,1,1078,847,231
Porcine circovirus 3,atgacaataaaagtccttatcttcaggacactcgtagcaccacaaaaactcagttatccagtccccgtcctgcggcatcaaaacacgaggccgcttcatcatccactgcccggtatatccactcacacggtgcggagcatccataatgggataccactttttctccctacagacctccgtggatccgggttccgaggtgccgggtaa,MTIKVLIFRTLVAPQKLSYPVPVLRHQNTRPLHHPLPGISTHTVRSIHNGIPLFLPTDLRGSGFRGAG,right to left,1,205,-2,207
Porcine circovirus 3,atggatgctccgcaccgtgtgagtggatataccgggcagtggatgatgaagcggcctcgtgttttgatgccgcaggacggggactggataactgagtttttgtggtgctacgagtgtcctgaagataaggacttttattgtcatcctattctaggtccggagggaaagcccgaaacacaggtggtgttttacgataaacaactggaccccgaccgagtgggaatctattgtggagtgtggaggcagtatagcgagataccttattatcggcaaagaggttggaaaaagcggtaccccacacttgcaagggtacgtgaatttcaagaacaaaaggcgactcagctcggtgaagcgcttacccggatttggtcgggcccatctggagccggcgagggggagccacaaagaggccagcgagtattgcaagaaagagggggattacctcgagattggcgaagattcctcttcgggtaccagatcggatcttcaagcagcagctcggattctgacggagacgtcgggaaatctgactga,MDAPHRVSGYTGQWMMKRPRVLMPQDGDWITEFLWCYECPEDKDFYCHPILGPEGKPETQVVFYDKQLDPDRVGIYCGVWRQYSEIPYYRQRGWKKRYPTLARVREFQEQKATQLGEALTRIWSGPSGAGEGEPQRGQRVLQERGGLPRDWRRFLFGYQIGSSSSSSDSDGDVGKSD,left to right,0,61,595,534
Porcine circovirus 3,atgcgggaaaacgcgggaagcttgtgcggatgcggctgcgcgggaattgcagttgtatttcaagccacgggggccttggtgggatggttataa,MRENAGSLCGCGCAGIAVVFQATGALVGWL,left to right,2,724,817,93
Porcine circovirus 3,atgagacacagagctatattcagaagaagaccccgcccaaggagacgacgacgccacagaaggcgctatgccagaagacgactattcattaggaggcccacagctggcacatactacacaaagaaatactccacaatgaacgtcatatccgttggaacccctcagaataacaagccctggcacgccaaccacttcattacccgcctaaacgaatgggaaactgcaattacctttgaatattataagatactaaaaatgaaagttacactcagccctgtaatttctccggctcagcaaacaaaaactatgttcgggcacacagccatagatctagacggcgcctggaccacaaacacttggctccaagacgacccttatgcggaaagttccactcgtaaagttatgacttctaaaaaaaaacacagccgttacttcacccccaaaccacttctggcgggaactaccagcgctcacccaggacaaagcctcttctttttctccagacccaccccatggctcaacacatatgaccccaccgttcaatggggagcactgctttggagcatttatgtcccggaaaaaactggaatgacagacttctacggcaccaaagaagtttggattcgttacaagtccgttctctaa,MRHRAIFRRRPRPRRRRRHRRRYARRRLFIRRPTAGTYYTKKYSTMNVISVGTPQNNKPWHANHFITRLNEWETAITFEYYKILKMKVTLSPVISPAQQTKTMFGHTAIDLDGAWTTNTWLQDDPYAESSTRKVMTSKKKHSRYFTPKPLLAGTTSAHPGQSLFFFSRPTPWLNTYDPTVQWGALLWSIYVPEKTGMTDFYGTKEVWIRYKSVL,right to left,0,1980,1335,645
Porcine circovirus 3,atgggataccactttttctccctacagacctccgtggatccgggttccgaggtgccgggtaatactagcccggcaccaaaatga,MGYHFFSLQTSVDPGSEVPGNTSPAPK,right to left,1,60,-24,84
Porcine circovirus 3,atgcctgcagtatttatacgctatgggcggggtttgcgtgatttttgcggggtgatggggttgggtaaaccgcgtgattttaaaactgaagtttatgtttttattggtcctccaggatgcgggaaaacgcgggaagcttgtgcggatgcggctgcgcgggaattgcagttgtatttcaagccacgggggccttggtgggatggttataatggggagggtgctgttattttggatgatttttatgggtgggttccatttgatgaattgctgagaattggggacaggtaccctctgagggttcctgttaagggtgggtttgttaattttgtggctaaggtattatatattactagtaatgttgtaccggaggagtggtattcatcggagaatattcgtggaaagttggaggccttgtttaggaggttcactaaggttgtttgttggggggaggggggggtaaagaaagacatggagacagtgtatccaataaactattga,MPAVFIRYGRGLRDFCGVMGLGKPRDFKTEVYVFIGPPGCGKTREACADAAARELQLYFKPRGPWWDGYNGEGAVILDDFYGWVPFDELLRIGDRYPLRVPVKGGFVNFVAKVLYITSNVVPEEWYSSENIRGKLEALFRRFTKVVCWGEGGVKKDMETVYPINY,left to right,0,608,1106,498
Porcine circovirus 3,atgtgggggatggggtccccacatgcgagggcgtttacctgtgcccgcacccgaagcgcagcgggagcgcgcgcgaggggacacggcttgtcgccaccggaggggtcagatttatatttattttcacttagagaacggacttgtaacgaatccaaacttctttggtgccgtagaagtctgtcattccagttttttccgggacataaatgctccaaagcagtgctccccattgaacggtggggtcatatgtgttga,MWGMGSPHARAFTCARTRSAAGARARGHGLSPPEGSDLYLFSLRERTCNESKLLWCRRSLSFQFFPGHKCSKAVLPIERWGHMC,left to right,3,1208,1463,255
